AAAAAAAAAAAAAAA
AM  W  W      A
ADWWW    WWW  A
A      WW     A
AWW  WW   WW  A
A   WWW       A
A     WW      A
A   WWWWWWw   A
A  WW    WWW WA
A    WWW   W  A
A  WWWW  WDWW A
A  WW    W    A
A WW  WW WWWWWA
A     WW D*  @D
AAYZAAAAAAAAAAA