AAAAAAAAAAAAAAA
AM   W        A
A WW WDWWW WWWA
A W      W    A
A W WWWWWWWWW A
A W     W     A
ADWWWWDWWWWDW A
A      W    W A
A WWWW WWWWWW A
A    W W      A
AWDW WWWWWW W A
A  W      W W A
A WWDWWWWDWDWWA
A       D-**-@D
AAYZAAAAAAAAAAA