AAAAAAAAAAAAAAA
A0000W0D000000A
A0000W0W00W0WDA
AWWWDW0WWWW0W0A
A0000000W0W0W0A
A0WWWWW0W0D0D0A
A0W000W0W0W0W0A
A0W0W0D0W000W0A
A0WDW0W000WDW0A
A000W0WWWW00W0A
ADWWW0W0000WW0A
A00000WDWW00D0A
AAAADAA000AAAAA
A0000AAAA0000@D
AAAAAAAAAAAAAAA