AAAAAAAAAAAAAAA
A  W  W     M A
ADWWW WW WWW  A
A      WW     A
AWW  WD W WW  A
A   WWW W WWDWA
A     WW   W  A
A   WDWWWWwD  A
AWWWW W  WWWDWA
A     D       A
A  WWWW  WDWW A
A  WWWD  W    A
A     WWDWWWWWA
AAA   D  D*--@D
AYZAAAAAAAAAAAA