AAAAAAAAAAAAAAA
A  W  W      MA
ADWWW WW WWWW A
A      WW     A
AWW  WD W WW  A
A   WWW W WWDWA
A WWW WW   W  A
A   WDWWWWwD  A
AWWWW W  WWWDWA
A     D       A
A  WWWWWWWDWW A
A  W     W    A
ADWW  WWDWWWWWA
A     W  D-*-@D
AYZAAAAAAAAAAAA