AAAAAAAAAAAAAAA
A000W0WW0WW000A
A0W0W0000W00W0A
A0W00WWW000WW0A
A00W00000WWW00A
AW0WWWW0W0000WA
A00WWW0000WWDWA
AW000WW0W0WW00A
AWW0W000W000WWA
AWW00WWWW0WDWWA
AWW0WW0W00W000A
A0D0W00W0WW00WA
A0WW00W000W0WWA
AWWWW0WW0WW00@D
AAAAAAAAAAAAAAA